#...###*.....####..#
#*##.#.####+.##.....
#....#.#.#...+..##.#
##>..+.......#..##.*
#...@..#.#.####.##..
#.#..#.#.#......<#.#
#.#..#...#...###%.$.
#.#.##.#.#....##.###
#........#......+.##
#.#..#####.$.##..###
#.##...#####.###..##
#*.###....+.......*#
##.######........#.#
#...####.##.###.####
##........####%..#*.
...+..<###.....####.
*.##........##...##.
#..#..#...#>*..+....
#..#.##.###.....##..
#...+.#!#...##...##*