#...######.%.####..*
#*##.#.###...##+..##
#....#.#.#.+.....###
##...+.......###.+.#
#>.....#.#+..##@...#
#.#..#.#.#......##.#
#.#..#...#..+###...#
#.#.##.#.#....##.###
#.....+..#.....*+.##
###..#.##..$.#######
##+..#######.####*##
..........+.......<#
#*##$####....#...###
#..#####.######.*###
##.......+####..+###
>....#####.....#..##
#..#....+...#..#.###
#.##*##...#..+..*###
#...####.###..####.#
###..*##!###...+####