###.%.###*....<##.@#
>*+....##....###+.##
..#.....+.##..+...#.
#.##.............+*<
#...+.#####.$.......
##>.......##....+..#
####..+.#########...
*###+...#....*####+.
..##...#..#########*
.##..+###......*####
.*##...######.#####!
.###+..#..*##.#####.
..###.+#.###+..###..
.###..##.##.....###.
.##.+....####..####.
.###..#####.+....##..
.+##....+#####......
...####.....+..#####
......##..+...######
%..+......##########