...*#.#..%...%.%...@
.########.###....###
.#..*.#*#..%........
.#..#.#.#.....#+...+
.#..#.#.#.+.........
....#...#.....+....+
.########....#.#....
.#*.#.#....+.....+..
.#.......#..........
...#######>....*...#
.>..+..%............
.+.>.....+...*.....<
....###..........<..
.+.#...+......+##...
..>...+....*..+..*<.
>...+.........+.....
.+.>..+*+...+.##...<
....+..+.........<..
+..>.....+......##..
>.+.!$...$...$.$.#.<